WWWWWWWWWWWWWWWWWWWWWWWWWWWWWW
WIIIIIIIIIIIIIIIIIIIIIIIIIIIIW
WIeIIIIIIIIIIIIIIIIIIIIIIIIIIW
WIIWWWWWIIIIIIIIIIIIIIIWWWWIIW
WIIWIIIIIIIIIIIIIIIIIIIIIIWIIW
WIIWIIIIIIIIIIIIIIIIIIIIIIWIIW
WIIIIIIIIIIIIIIIIIIIIIIIIIIIIW
WIIIIIIIIIIIIIIIIIIIIIIIIIIIIW
WIIIIIIIIIIIIIIIIIIIIIIIIIIIIW
WIIIIIIIIIIIIIIIIIIIIIIIIIIIIW
WIIWIIIIIIIIIIIIIIIIIIIIIIWIIW
WIIWIIIIIIIIIIIIIIIIIIIIIIWIIW
WIIWWWWIIIIIIIIIIIIIIIIWWWWIIW
WIIIIIIIIIIIIIIIIIIIIIIIIIIIIW
WIIIIIIIIIIIIIIIIIIIIIIIIIIIIW
WWWWWWWWWWWWWWWWWWWWWWWWWWWWWW
