WWWWWWWWWWWWWWWWWWWWWWWWWWWWWW
WeIIIIIIIIIIIIIIIIIIIIIIIIIIIW
WIIIIIIIIIIIIIIIIIIIIIIIIIIIIW
WIIWWWWWIIIIIIIIIIIIIIIWWWWIIW
WIIWIIIIIIIIIIIIIIIIIIIIIIWIIW
WIIWIIIIIIIIIIIIIIIIIIIIIIWIIW
WIIIIIIIIIIIIIIIIIIIIIIIIIIIIW
WIIIIIIIIIIIIIIIIIIIIIIIIIIIIW
WIIIIIIIIIIIIIIIIIIIIIIIIIIIIW
WIIWIIIIIIIIIIIIIIIIIIIIIIWIIW
WIIWIIIIIIIIIIIIIIIIIIIIIIWIIW
WIIWWWWIIIIIIIIIIIIIIIIWWWWIIW
WIIIIIIIIIIIIIIIIIIIIIIIIIIIIW
WIIIIIIIIIIIIIIIIIIIIIIIIIIIIW
WWWWWWWWWWWWWWWWWWWWWWWWWWWWWW
