WWWWWWWWWWWWWWWWWWWWWWWWWWWWWW
WaGGGGGGGGGGGGGGGGGGGGGWWGGGGW
WGGWWWWWWWWGGGWWWWWWWGGWWGWGGW
WWGGGGGGGGGGGGWGGGGGGGGGGGWGGW
WGGWWWWGGGWWWWWGWWWGGWWWWWWGGW
WGGWGGGGGGWGGGGGGGGGGGGGGGWGGW
WGGWGGWWWWWWWWGGWWWWWWWWWWWGGW
WGGGGGWGGGGGGGGGGGGGGGGGGWWGgW
WGGWWWWGGWWWGWWWWWWWGWWGGWWWWW
WGGGGGGGGGWGGGGGGGGGGWWGGGGGGW
WGGGGWWWWWWGGWWWWGGGGWWWGWGGGW
WWWGGGGGGGGGGWWGGGGGGGGWGWGGGW
WGGGWWGGGWGGGWWWWWWWWGGWGWGGGW
WGGGWWGGGWGGGGGGGGGWWGGGGWGGGW
WGGGGGGGGGGGWWGGGGGGGGGWWWGjGW
WWWWWWWWWWWWWWWWWWWWWWWWWWWWWW
