WWWWWWWWWWWWWWWWWWWWWWWWWWWWWW
WaGGGGGWWGGGGGGGGGGGGGGGWWGGGW
WGGWWWWWWWWGGWWWWWWWWGGWWGGGGW
WGGGGGGGGGWGGGGGGGGGWGGGGGGGGW
WGGWWWWGGWWWWWWGGWWGGWWWWWWGGW
WGGWGGGGGGGGGGGWGGGGGGGGGGGGGW
WWWWGGWWWWGGWWWWWWWWWWGGWWWWWW
WGGGGGGGGGGGGGGGGGGGGGGGGgGGGW
WGGWWWWGGWWWWWWWWWWGGGWWWWWWWW
WGGGGWGGGGGGWGGGGGGWGGGGGGGGGW
WGGGGWWWWWWGGWWWWGGGGGGGWWGGGW
WGGGGGGGGGWGGGGGGGGGGGGGGWGGGW
WGGGWWWWWWGGWWWWWWWWGGGGGWGGGW
WGGGGGGGGGGGGGGGGGGGGGGGGGGGGW
WGGGGGGGGGGGGGGGGGGGGGGGGGGjGW
WWWWWWWWWWWWWWWWWWWWWWWWWWWWWW
