WWWWWWWWWW
WS      EW
W WWWW  W
W      WW
WWWWWWWWWW
