WWWWWWWWWWWWWWWWWWWWWWWWWWWWWW
WaGGGGGGGGGGGGGGGGGGGGGWWGGGGW
WGGWWWWWWWWGGGWWWWWWWGGWWGWGGW
WWGGGGGGGGGGGGWGGGGGGGGGGGWGGW
WGGWWWWGGGWWWWWGWWWGGWWWWWWGGW
WGGWGGGGGGWGGGGGGGGGGGGGGGWGGW
WGGWGGWWWWWWWWGGWWWWWWWWWWWGGW
WGGGGGWGGGGGGGGGGGGGGGGGGWWGgW
WGGWWWWGGWWWGWWWWWWWGWWGGWWWWW
WGGGGGGGGGWGGGGGGGGGGWWGGGGGGW
WGGGGWWWWWWGGWWWWGGGGWWWGWGGWW
WWWGGGGGGGGGGWWGGGGGGGGWGWGGWW
WGGGWWGGGWGGGWWWWWWWWGGWGWGGWW
WGGGWWGGGWGGGGGGGGGWWGGGGWGGGW
WGGGGGGGGGGGWWGGGGGGGGGWWGGjGW
WWWWWWWWWWWWWWWWWWWWWWWWWWWWWW
