WWWWWWWWWWWWWWWWWWWWWWWWWWWWWW
WaGGGGGGGGGGGGGGGGGGGGGGGGGGGW
WGGWWWWWWWGGWWWWWWWGGWWWWGGGGW
WGGWGGGGGWGGGGGGGGGWGGGWGGGGGW
WGGWGGWWWGGWWWWGGWWGGGWGGGGWWW
WGGGGGWGGGGGWWGGGGGGGWGGGGGGWW
WWWWGGWWWWGGWWWWGGWWWWGGWWGGGW
WGGGGGGGGGGGGGGGGGGGGGGGGGGGGW
WGGWWWWGGWWWWWWWWWWGGGWWWWWWWW
WGGGWWGGGGGGGGGGGGGWGGGGGGGGGW
WGGGGWWWWWWGGWWWWGGGGGGGWWGGGW
WGGGGGGGGGWGGGGGGGGGGGGGGWGGGW
WGGGGWWWWWWGGWWWWWWWWGGGGWGGGW
WGGGGGGGGGGWWWGGGGGGGGGGGGGGgW
WGGGGGGGGGGGGGGGWWWGGGGGGGGGGW
WWWWWWWWWWWWWWWWWWWWWWWWWWWWWW
