WWWWWWWWWWWWWWWWWWWWWWWWWWWWWW
WjGGGGGGGGGGGGGGGGGGGGGGGGGGGW
WWWWWWWWWWWWWWWWWWWWWWWWGGGWGW
WGGWWGGGGGWWGGGGGGWWGGGGGGGWGW
WGGGGGGGGGGGGGGGGGWWGGGGWWWWGW
WGGGWWGGGWWGGWGGGGWWGGGGGGGGGW
WGGWWGGGGGWWGWGGGGGGGGGGWGGGGW
WGGGWWGGGWWGGWGGGGGWGGGGWGGGGW
WGGGGWWaWWGGGWWWWWWWGGGGWWWGGW
WGGWGGGWGGGGGWGGGGGGGGGGGGGGGW
WGGWWWWWWWGGGWGGGWGGGWWGGWWGGW
WGGWGGGGGGGGGGGGGWGGGWWGGWWGGW
WGGGGGGWWWWWWWWGGWGGGGGGGGGGGW
WWWWWWWWGGGGGWWGGWWWWWWWWGGGGW
WgGGGGGGGGGGGGGGGGGGGGGGGGGGGW
WWWWWWWWWWWWWWWWWWWWWWWWWWWWWW
