WWWWWWWWWWWWWWWWWWWWWWWWWWWWWW
WcYYYYYYYWYYYYYWYYYYYYYYYYYYYW
WYWWWWWWYWYWWWYWYWWWWWYWWWWWYW
WYWYYYYYWYWYYYWYWYYYYYWYYYYYYW
WYWYWWWWWYWYWWWYWYWWWWWWWWWWYW
WYWYWYYYYYWYWYYYWYWYYYYYYYYYYW
WYWYWYWWWWWYWYWWWYWYWWWWWWWWYW
WYWYWYWYYYWYWYWYYYWYWYYYYYYYYW
WYWYWYWYWWWYWYWYWWWYWYWWWWWWYW
WYWYWYWYYYWYWYWYYYWYWYYYYYWYYW
WYWYWYWYWWWYWYWYWWWYWYWWWWWWYW
WYWYWYWYYYYYWYWYYYWYYYYYWYYYYW
WYWYWYWWWWWWWYWYWWWWWWWWWWWWYW
WYWYYYYYYYYYYYYYYYYYYYYYYYYYdW
WYWWWWWWWWWWWWWWWWWWWWWWWWWWWW
WWWWWWWWWWWWWWWWWWWWWWWWWWWWWW
