WWWWWWWWWWWWWWWWWWWWWWWWWWWWWW
WGGjGWGaGGGGGGGGGGGGGGGGGGGGGW
WGGGWWWWWWWWWWWWWWWWWWWWGGGWGW
WGGGWWGGGGGGGGGGGGWWGGGGGGGWGW
WGGGGGGGGGGGGWGGGGWWGGGGWWWWGW
WGGGWWGGGWWGGWGGGGWWGGGGGGGGGW
WGGWWGGGGGWWGGGGGGGGGGGGWGGGGW
WGGGWWGGGWWGGGGGGGGWGGGGWGGGGW
WGGGGWGGGWGGGWWWWWWWGGGGWWWGGW
WGGGGGGGGGGGGWGGGGGGGGGGGGGGGW
WGGWWWWWWWGGGWGGGWGGGWWGGWWGGW
WGGWGGGGGGGGGGGGGWGGGWWGGWWGGW
WGGGGGGWWWWWWWWGGWGGGGGGGGGGGW
WWWWWWWWGGGGGWWGGWWWWWWWWGGGGW
WgGGGGGGGGGGGGGGGGGGGGGGGGGGGW
WWWWWWWWWWWWWWWWWWWWWWWWWWWWWW
