WWWWWWWWWWWWWWWWWWWWWWWWWWWWWW
WcYYYYYYYWYYYYYWYYYYYYYYYYYYYW
WYWWWWWWYWYWWWYWYWWWWWYWWWWWYW
WYWYYYYYYYWYYYWYWYYYYYWYYYYYYW
WYWYWWWWWYWYWWWYWYWWWWWWWWWWYW
WYWYWYYYYYWYWYYYWYWYYYYYYYYYYW
WYWYWYWWWWWYWYWWWYWYWWWWWWWWYW
WYWYWYWYYYWYWYWYYYWYWYYYYYYYYW
WYWYWYWYWWWYWYWYWWWYWYWWWWWWYW
WYWYWYWYYYWYWYWYYYWYWYYYYYWYYW
WYWYWYWYWWWYWYWYWWWYWYWWWWWWYW
WYWYWYWYYYYYWYWYYYWYYYYYWYYYYW
WYWYWYWWWWWWWYWYWWWWWWWWWWWWYW
WYWYYYYYYYYYYYYYYYYYYYYYYYYYhW
WYWWWWWWWWWWWWWWWWWWWWWWWWWWWW
WWWWWWWWWWWWWWWWWWWWWWWWWWWWWW
