WWWWWWWWWWWWWWWWWWWWWWWWWWWWWW
WYYlWWWhYYYYYYYYWYYYYYYYYYYYYW
WYYWWWWWYYWWWWYYWWWWWYYWWWWYYW
WYYYYYYWWWWYYYYYYYYYYYYYYYYYYW
WWWWWYYYYYWWWWWYWYWWWWWWWWWWYW
WYWYYYYYYYWYYYYYWYWYYYYYYYYYYW
WYWYYWWWWWWYYYYWWYWYWYYYWWWWYW
WYWYYYYYYYYYWYYWYYWYWWWYYYYYcW
WYWWWWWYYYYYWYYWYYWYYYYYYYWYYW
WYYYYYWYYYYYWYYWYYWYYWWWYYWYYW
WYYYWYWWWWWWWYYWYYWYYYYYYWWYYW
WYYYWYYYYYYYYYYYYYYYYYYYWWWYYW
WYYYWWWWWWWWWWWWWWWWWWYYYWWYYW
WYYYYWWYYYYYYYYYYYYYYWYYYYWYYW
WYYYYYYYYYYYYYWWYYYYYYYYYYYYYW
WWWWWWWWWWWWWWWWWWWWWWWWWWWWWW
