WWWWWWWWWWWWWWWWWWWWWWWWWWWWWW
WeIIIIIIIWIIIIIWIIIIIIIIIIIIIW
WIWWWWWWIWIWWWIWIWWWWWIWWWWWIW
WIWIIIIIWIWIIIWIWIIIIIWIIIIIIW
WIWIWWWWWIWIWWWIWIWWWWWWWWWWIW
WIWIWIIIIIWIWIIIWIWIIIIIIIIIIW
WIWIWIWWWWWIWIWWWIWIWWWWWWWWIW
WIWIWIWIIIWIWIWIIIWIWIIIIIIIIW
WIWIWIWIWWWIWIWIWWWIWIWWWWWWIW
WIWIWIWIIIWIWIWIIIWIWIIIIIWIIW
WIWIWIWIWWWIWIWIWWWIWIWWWWWWIW
WIWIWIWIIIIIWIWIIIWIIIIIWIIIIW
WIWIWIWWWWWWWIWIWWWWWWWWWWWWIW
WIWIIIIIIIIIIIIIIIIIIIIIIIIIfW
WIWWWWWWWWWWWWWWWWWWWWWWWWWWWW
WWWWWWWWWWWWWWWWWWWWWWWWWWWWWW
