WWWWWWWWWWWWWWWWWWWWWWWWWWWWWW
WhYYYYYYWYYYYYYYYYYYYYYYYYYYYW
WYWWWWYYWYYYYYWWWWWYYWWWWYYYYW
WYYYYYYYWYYYYYWYYYYYYYYYWYYYYW
WYYYWWWWWYYWYYWYYYWWWYYYWWYYYW
WYYYYYYYYYYWYYWYYYYYYYYYWWYYYW
WWWWWWWWWWWWYYWYYYYYWYYYWWYYYW
WYYYYYYYYYYYYYYYYYYYWYYYWWYYYW
WYYYWWWWWYYWWWWWWWWWWYYYWWYYYW
WYYYWYYYWYYYYYYYYYYYYYYYWWYYYW
WYWYWYYYWYYYWWWWYYYYYYWWWWYYYW
WYWYYYYYYYYYYYYWYYWYYYWYYWYYYW
WYWWWWWWWWYYWWWWWWWYYYWYYWYYYWY
WYYYYYYYYWYYYYYYYYWYYYYYYWYYYW
WcYYYYYYYYYYYYYYYYWWWWWWWWYlYW
WWWWWWWWWWWWWWWWWWWWWWWWWWWWWW
