WWWWWWWWWWWWWWWWWWWWWWWWWWWWWW
WaYYYYYYYYYYYYYYYYYYYYYYYYYYYW
WYYWWWWWWWYYWWWWWWWYYWWWWYYYYW
WYYWYYYYYWYYYYYYYYYWYYYWYYYYYW
WYYWYYWWWYYWWWWYYWWYYYWYYYYWWW
WYYYYYWYYYYYWWYYYYYYYWYYYYYYWW
WWWWYYWWWWYYWWWWYYWWWWYYWWYYYW
WYYYYYYYYYYYYYYYYYYYYYYYYYYYYW
WYYWWWWYYWWWWWWWWWWYYYWWWWWWWW
WYYYWWYYYYYYYYYYYYYWYYYYYYYYYW
WYYYYWWWWWWYYWWWWYYYYYYYWWYYYW
WYYYYYYYYYWYYYYYYYYYYYYYYWYYYW
WYYYYWWWWWWYYWWWWWWWWYYYYWYYYW
WYYYYYYYYYYWWWYYYYYYYYYYYYYYYW
WYYYYYYYYYYYYYYYWWWYYYYYYYYYYW
WWWWWWWWWWWWWWWWWWWWWWWWWWWWWW
