WWWWWWWWWWWWWWWWWWWWWWWWWWWWWW
WhYYYYYYWYYYYYYYYYYYYYYYYYYYYW
WYWWWWYYWYkYYYWWWWWYYWWWWYYYYW
WYYYYYYYWYYYYYWYYYYYYYYYWYYYYW
WYYYWWWWWYYWYYWYYYWWWYYYWWYYYW
WYYYYYYYYYYWYYWYYYYYYYYYWWYYYW
WWWWWWWWWWWWYYWYYYYYWYYYWWYYYW
WYYYYYYYYYYYYYYYYYYYWYYYWWYYYW
WYYYWWWWWYYWWWWWWWWWWYYYWWYYYW
WYYYWYYYWYYYYYYYYYYYYYYYWWYYYW
WYWYWYYYWYYYWWWWYYYYYYWWWWYYYW
WYWYYYYYYYYYYYYWYYWYYYWYYWYYYW
WYWWWWWWWWYYWWWWWWWYYYWYYWYYYW
WYYYYYYYYWYYYYYYYYWYYYYYYWYYYW
WcYYYYYYYYYYYYYYYYWWWWWWWWYlYW
WWWWWWWWWWWWWWWWWWWWWWWWWWWWWW
