WWWWWWWWWWWWWWWWWWWWWWWWWWWWWW
WIIIIIIiWIIIIIIIIIIIIIIIIIIIIW
WIIIIIIIWIIIIIIIIIIIIIIIIIIIIW
WIIIIIIIWIIIWWIIIIIWWIIIWIIIIW
WIIWWWIIWIIWWIIIIIIIWWIIWIIIIW
WIIWIIWIWIIWWIIIIIIIWWIIWIIIIW
WIIWWWIIWIWWWIIIIIIIWWWIWIIIIW
WIIWIIWIWWWIIIIIIIIIIIWWWIIIIW
WIIWWWIIWWIIIIIIIIIIIIIWWIIIIW
WIIIIIIIWWWWIIIIIIIIIWWWWIIIIW
WIIWWWIIWWWWIIIIIIIIIWWWWIIIIW
WIIWIIIIWWWWIIIIfIIIIWWWWIIIIW
WIIWWWIIWWWWWWWWWWWWWWWWWIIIIW
WIIIIWIIIIIIIIIIIIIIIIIIIIIIIW
WIIWWWIIIIIIIIIIIIIIIIIIIIIIeW
WWWWWWWWWWWWWWWWWWWWWWWWWWWWWW
