WWWWWWWWWWWWWWWWWWWWWWWWWWWWWW
WIIIIIIIIWIIIIIWIIIIIIIIIIIIIW
WIWWWWWWIWIWWWIWIWWWWWIWWWWWIW
WIWIIIIIIIWIIIWIWIIIIIWIIIIIIW
WIWIWWWWWIWIWWWIWIWWWWWWWWWWIW
WIWIWIIIIIWIWIIIWIWIIIIIIIIIIW
WIWIWIWWWWWIWIWWWIWIWWWWWWWWIW
WIWIWIWIIIWIWIWIIIWIWIIIIIIIIW
WIWIWIWIWWWIWIWIWWWIWIWWWWWWIW
WIWIWIWIIIWIWIWIIIWIWIIIIIWIIW
WIWIWIWIWWWIWIWIWWWIWIWWWWWWIW
WIWIWIWIIIIIWIWIIIWIIIIIWIIIIW
WIWIWIWWWWWWWIWIWWWWWWWWWWWWIW
WIWIIIIIIIIIIIIIIIIIIIIIIIIIiW
WIWWWWWWWWWWWWWWWWWWWWWWWWWeWW
WWWWWWWWWWWWWWWWWWWWWWWWWWWWWW
