WWWWWWWWWWWWWWWWWWWWWWWWWWWWWW
WaIIIIIIIIIIIIIIIIIIIIIIIIIIIW
WIIWWWWWWWIIWWWWWWWIIWWWWIIIIW
WIIWIIIIIWIIIIIIIIIWIIIWIIIIIW
WIIWIIWWWIIWWWWIIWWIIIWIIIIWWW
WIIIIIWIIIIIWWIIIIIIIWIIIIIIWW
WWWWIIWWWWIIWWWWIIWWWWIIWWIIIW
WIIIIIIIIIIIIIIIIIIIIIIIIIIIIW
WIIWWWWIIWWWWWWWWWWIIIWWWWWWWW
WIIIWWIIIIIIIIIIIIIWIIIIIIIIIW
WIIIIWWWWWWIIWWWWIIIIIIIWWIIIW
WIIIIIIIIIWIIIIIIIIIIIIIIWIIIW
WIIIIWWWWWWIIWWWWWWWWIIIIWIIIW
WIIIIIIIIIIWWWIIIIIIIIIIIIIIIW
WIIIIIIIIIIIIIIIWWWIIIIIIIIIIW
WWWWWWWWWWWWWWWWWWWWWWWWWWWWWW
