WWWWWWWWWWWWWWWWWWWWWWWWWWWWWW
WiWeIIIIIIIIIIIIIIIIIIIIIIIIIW
WIWWWWWWIIIWWWWWWWWWWWWWIIIIIW
WIWIIIIWIIIWIIIIIIIIIIIWIIWWWW
WIWIIIIWIIIWIIIWWWWWIIIWIIWIIW
WIIIIIIWIIIIIIIWIIIIIIIIIIWIIW
WWWIIIIWWWWWIIIWIIIIWWWWWWWIIW
WWWIIIIWIIIIIIIWIIIIWWIIIIIInW
WIIIWWWWWWWWIIIWIIIIWWWWWWIIIW
WIIIWWIIIIIIIIIWIIIIIIIIIWIIIW
WIIIIWWIIIWWWWWWIIIWIWIIIWWIIW
WIIIIIIIIIWIIIIIIIIIIIIIIIWIIW
WIIIIWWWWWWIIIIWWWWWWIIIIIWIIW
WIIIIIIIIIIWWIIIIIIIIIIIIIIIIW
WIIIIIIIIIIIIIIIWWWIIIIIIIIIIW
WWWWWWWWWWWWWWWWWWWWWWWWWWWWWW
